,0,1,2,3,4,5,6
0,0,0,0,0,0,0,0
1,1,0,1,0,0,0,0
2,1,0,0,0,0,1,0
3,0,0,0,1,0,0,0
4,0,1,0,0,0,0,0
5,0,1,0,0,1,0,1
6,0,0,0,0,1,0,0
